TILEMAP
36 23 							-- Size of tile map in tiles
16 32 							-- Tile size & block size
5							-- Number of Tiles to paint
images/blocks.png 	-- Tilesheet
2 2 								-- Number of tiles in tilesheet
111111111111111111111111111111111111
111111111111111111111111111111111111
11                                11
11                                11
11                     6          11
11        5                       11
11       222222222222222222       11
11             111111   6         11
11             111111             11
11     2222222211111122222222     11
11             111111             11
11             111111             11
11   22222222221111112222222222   11
11                                11
11                                11
11   2222                  2222   11
11                                11
11                                11
11   22                      22   11
11                     7          11
11                                11
112222222222223333333322222222222211
111111111111111111111111111111111111
